Document-DespatchAdvice/DespatchAdvice-Header/DocumentType	ТипДокумента	Тэг
Document-DespatchAdvice/DespatchAdvice-Header/DocumentID	ИдДокумента	Тэг
Document-DespatchAdvice/DespatchAdvice-Header/BuyerOrderNumber	НомерЗаказа	Тэг
Document-DespatchAdvice/DespatchAdvice-Header/DespatchAdviceNumber	НомерДокумента	Тэг
Document-DespatchAdvice/DespatchAdvice-Header/DespatchAdviceDate	ДатаДокумента	Тэг
Document-DespatchAdvice/DespatchAdvice-Header/EstimatedDeliveryDate	ДатаДоставки	Тэг
Document-Order/Order-Header/OrderCurrency	Валюта	Тэг
Document-Order/Order-Header/Remarks	Комментарий	Тэг
Document-DespatchAdvice/Document-Parties/Sender/ILN	ОтправительГЛН	Тэг
Document-DespatchAdvice/Document-Parties/Sender/Name	ОтправительИмя	Тэг
Document-DespatchAdvice/Document-Parties/Receiver/ILN	ПолучательГЛН	Тэг
Document-DespatchAdvice/Document-Parties/Receiver/Name	ПолучательИмя	Тэг
Document-DespatchAdvice/DespatchAdvice-Parties/Buyer/ILN	ПокупательГЛН	Тэг
Document-DespatchAdvice/DespatchAdvice-Parties/Buyer/Name	ПокупательИмя	Тэг
Document-DespatchAdvice/DespatchAdvice-Parties/Seller/ILN	ПродавецГЛН	Тэг
Document-DespatchAdvice/DespatchAdvice-Parties/Seller/Name	ПродавецИмя	Тэг
Document-DespatchAdvice/DespatchAdvice-Parties/DeliveryPoint/ILN	ТочкаДоставкиГЛН	Тэг
Document-DespatchAdvice/DespatchAdvice-Parties/DeliveryPoint/Name	ТочкаДоставкиИмя	Тэг
Document-DespatchAdvice/DespatchAdvice-Consignment/Packing-Sequence/Line/Line-Item	СтрокиДокумента	СтрокиДокумента
Line-Item/LineNumber	НомерСтроки	СтрокаДокумента
Line-Item/EAN	Штрихкод	СтрокаДокумента
Line-Item/BuyerItemCode	КодПокупателя	СтрокаДокумента
Line-Item/ItemDescription	Товар	СтрокаДокумента
Line-Item/QuantityDespatched	Количество	СтрокаДокумента
Line-Item/UnitOfMeasure	ЕдиницаИзмерения	СтрокаДокумента
Line-Item/UnitNetPrice	ЦенаБезНДС	СтрокаДокумента
Line-Item/TaxRate	СтавкаНДС	СтрокаДокумента
Line-Item/SuggestedPrice	СуммаБезНДС	СтрокаДокумента
Document-DespatchAdvice/DespatchAdvice-Summary/TotalLines	ВсегоСтрок	Тэг
Document-DespatchAdvice/DespatchAdvice-Summary/TotalGoodsDespatchedAmount	ВсегоКоличество	Тэг