Document-Order/Document-Header/DocumentID	ИдДокумента	Тэг
Document-Order/Order-Header/OrderNumber	НомерДокумента	Тэг
Document-Order/Order-Header/OrderDate	ДатаДокумента	Тэг
Document-Order/Order-Header/ExpectedDeliveryDate	ДатаДоставки	Тэг
Document-Order/Order-Header/OrderCurrency	Валюта	Тэг
Document-Order/Order-Header/Remarks	Комментарий	Тэг
Document-Order/Document-Parties/Sender/ILN	ОтправительГЛН	Тэг
Document-Order/Document-Parties/Sender/Name	ОтправительИмя	Тэг
Document-Order/Document-Parties/Receiver/ILN	ПолучательГЛН	Тэг
Document-Order/Document-Parties/Receiver/Name	ПолучательИмя	Тэг
Document-Order/Order-Parties/Buyer/ILN	ПокупательГЛН	Тэг
Document-Order/Order-Parties/Buyer/Name	ПокупательИмя	Тэг
Document-Order/Order-Parties/Seller/ILN	ПродавецГЛН	Тэг
Document-Order/Order-Parties/Seller/Name	ПродавецИмя	Тэг
Document-Order/Order-Parties/DeliveryPoint/ILN	ТочкаДоставкиГЛН	Тэг
Document-Order/Order-Parties/DeliveryPoint/Name	ТочкаДоставкиИмя	Тэг
Document-Order/Order-Lines/Line/Line-Item	СтрокиДокумента	СтрокиДокумента
Line-Item/LineNumber	НомерСтроки	СтрокаДокумента
Line-Item/EAN	Штрихкод	СтрокаДокумента
Line-Item/BuyerItemCode	КодПокупателя	СтрокаДокумента
Line-Item/SupplierItemCode	КодПоставщика	СтрокаДокумента
Line-Item/ItemDescription	Товар	СтрокаДокумента
Line-Item/ItemStatus	СтатусСтроки	СтрокаДокумента
Line-Item/OrderedQuantity	ЗаказанноеКоличество	СтрокаДокумента
Line-Item/OrderedUnitPacksize	Коэффициент	СтрокаДокумента
Line-Item/UnitOfMeasure	ЕдиницаИзмерения	СтрокаДокумента
Line-Item/OrderedUnitNetPrice	ЦенаБезНДС	СтрокаДокумента
Line-Item/TaxRate	СтавкаНДС	СтрокаДокумента
Line-Item/OrderedNetAmount	СуммаБезНДС	СтрокаДокумента
Line-Item/OrderedTaxAmount	СуммаНДС	СтрокаДокумента
Document-Order/Order-Summary/TotalLines	ВсегоСтрок	Тэг
Document-Order/Order-Summary/TotalOrderedAmount	ВсегоКоличество	Тэг
Document-Order/Order-Summary/TotalNetAmount	ВсегоСуммаБезНДС	Тэг